#  ##############################################
#  #
#  #
#  #   ##########  #  ##################
#         #        #   
#         #        #   
#  #####  ##############################
#      #           #
####   #           #
#      ##########  #
#      #           # 
#      #           #
#  #####  ##########
#  #      #        #
#  #      #        #
#  #####  #  #  #  #    
#  #      #  #  #  #
#  #      #  #  #  #
#  #  #####  #######
#  #  #      #
#  #  #      #
#  #  #####  #
#  #      #  #
#  #      #  #
###########  #